%%%%%%%%%
%%%%%%%%%
%%%%%%%%%
%%%%%%%%%
%%% %R%%%
%%%%^%%%%
%%%%%%%%%
