%%%%%%%%%
%%%%%%%%%
%%%%%%%%%
%%%%%%%%%
%%%R% %%%
%%%%^%%%%
%%%%%%%%%
