#########
#########
#####R# #
###### ##
### # ###
####^####
#########
