%%%%%%%%%
%%%%R%%%%
% % % % %
%% %%% %%
%%% % %%%
%%%%^%%%%
%%%%%%%%%
