%%%%%%%%%
%%%%%%%%%
%%%%%%%%%
%%%%%%%%%
%%%R%R%%%
%%%%^%%%%
%%%%%%%%%
