%%%%%%%%%
%%%%%%%%%
%%%%%R% %
%%%%%% %%
%%% % %%%
%%%%^%%%%
%%%%%%%%%
