%%%%%%%%%
%%%%R%%%%
%% %  % %
%%% %% %%
%%% % %%%
%%%%^%%%%
%%%%%%%%%
