%%%%%%%%%%%%%%%%%%%%%%%%%%%%%%
%      %   % %  % %%  %      %
% % %% % %    %      %  %%%% %
% % %  %%  %% % % % %  %   % %
%%  % % % %%%  %  %   % % %% %
%  %  %    % % %%%  %%  % %  %
%% % %  %% % %   % %   %  % %%
%  %  % %  %  %% %   % % %  %%
% % %  %% %%% %% % % % % % % %
%    % %  %%%    %  %  % % % %
%%% %  % % %  %%% %  % % %   %
%   % %  %  % %   %% % %  % %%
% % %   % % % % %   %%  %    %
%  % %%%%   %   % %   %  % % %
%% %      %  % % % %%  %  %  %
%  %% %%%% %  %      % %%  % %
% %   %      %  %%%%%%  %% % %
% %%%  % %% %  %      %  % % %
%    % % % %  %  %% %  %   % %
% %% % %     %% %  %  % %%%% %
%  % %  %%%%%   % %  %  %    %
% %  %% %     %%   %   %  % %%
%%  %   % %%%%  %%  % %% % % %
%  % % %% %    %   %% %  %   %
% %  %    % %% % % %  % %  % %
%   %  %%%  %    % % %  % %  %
%% %  %   %  % %%% % % %  % %%
%  % %  %  %  %    %    % % %%
% %    %%%   %  % %  %%   %  %
%%%%%%%%%%%%%%%%%%%%%%%%%%%%%%
