%%%%%%%%%
%%%%%%%%%
%%%%%%%%%
%%%%%R%%%
%%%d% %%%
%%%%^%%%%
%%%%%%%%%