%%%%%%%%%
%%%%%%%%%
%%%%%%%%%
%%%R%%%%%
%%% %d%%%
%%%%^%%%%
%%%%%%%%%