%%%%%%%%%
%%%%%%%%%
%%%%%%%%%
%%%%%%%%%
%%%R%d%%%
%%%%^%%%%
%%%%%%%%%
