%%%%%%%%%
%%%%%%%%%
%%%%%%%%%
%%%%%%%%%
%%%d%R%%%
%%%%^%%%%
%%%%%%%%%
