%%%%%%%%%%%%%%%%%%%%%%%%%%%%
%%%%%%%%%%%%%%%%%%%%%%%%%%%%
%%%%%%%%%%%%%%%%%%%%%%%%%%%%
%%%%%%    c       1%%%%%%%%%
%%%%%% %%%%%%% %%%%%%%%%%%%%
%%%%%% %%%%%%% %%%%%%%%%%%%%
%%%%%% %%%%%%% %%%%%%%%%%%%%
%%    a           b%%%%%%%%%
%%%%%%%%%% %%%%%%%%%%%%%%%%%
%%%%%%%%%% %%%%%%%%%%%%%%%%%
%%%%%%%%%% %%%%%%%%%%%%%%%%%
%%%%%%%%%%^%%%%%%%%%%%%%%%%%
%%%%%%%%%%%%%%%%%%%%%%%%%%%%