%%%%%%
%%R% %
%%% %%
% % %%
%%^%%%
%%%%%%
