%%%%%%
%%R%d%
%%% %%
%d% %%
%%^%%%
%%%%%%
