%%%%%%
%%1% %
%%% %%
% % %%
%%^%%%
%%%%%%
