%%%%%%%%%%
%%%%1%%% %
%%%% %%% %
%%%%% % %%
%%%%%% %%%
%% %%% %%%
%% %%% %%%
%%% % %%%%
%%%% %%%%%
%%%%^%%%%%
%%%%%%%%%%
