%%%%%%%%%%
%%%%R%%% %
%%%% %%% %
%%%%% % %%
%%%%%% %%%
%% %%% %%%
%% %%% %%%
%%% % %%%%
%%%% %%%%%
%%%%^%%%%%
%%%%%%%%%%
