%%%%%%%%%
%%%1% %%%
%%% % %%%
%%%   %%%
%% % %%%%
%% % %%%%
%%   %%%%
%%%^%%%%%
%%%%%%%%%
