%%%%%%%%%%%%%%%%%%%%%%%%%%%%%%
%     %%   %       % % %   %%%
% %% %   %   % % %       %  %%
%  %   %% % % %   % % % % %  %
%%  %%%    %   % %  %%  %  % %
% % % % %% % % %%  %   %  %  %
% % % % %%   %   %%  %%  %1 %%
% %   %   % % %%   % % %  %  %
%   % % %  %  %  % %    %   %%
% %% %   %  %  % % % %%  %%  %
% %   %% % % %  %   % %% % % %
% % %   %  %  %   % %    %   %
% %  %%  %  %  %%%   % %% %% %
% %% % %  %  %    %%   %    %%
%  % %  %  %   %%   %%%  %%  %
%% %  %  %  % %   %    %   % %
%  % %%%  %  %  %%  %% % % % %
% %  %%  % % % %  %% % %  %  %
%%  %   %  % %  %    %   %% %%
%% % % %  %%  %  %% % %%%   %%
%  %     %  %  %        % %  %
% %  %%%   %  %%% % %%% % %%%%
% % %    %  %  %   %   %%    %
% %% % %% %  % % % % %   % % %
%    % %   %%%  %  % %%%  %  %
% % %  % %     %  %     %  % %
%%% % %   % %%%% % % %%  %   %
%   %   %  %%   %   %   % %% %
%S%%  %  %    %   %   %%     %
%%%%%%%%%%%%%%%%%%%%%%%%%%%%%%
