%%%%%%%%%%%%
%%%%%1%%% %%
%%%%% %%% %%
%%%%% %%% %%
%%%%%     %%
%% %%%% %%%%
%% %%%% %%%%
%%      %%%%
%%%% %%%%%%%
%%%%S%%%%%%%
%%%%%%%%%%%%

