%%%%%%%%
%%%1%%%%
%%% %%%%
%% %%%%%
%%^%%%%%
%%%%%%%%
