%%%%
%%1%
%  %
% %%
%^%%
%%%%
