%%%%%%%
%>  a1%
%%%%%%%
%     %
%%%%%%%
