%%%%%%%%
%%%1%%%%
%%  %%%%
%% %%%%%
%%^%%%%%
%%%%%%%%
