%%%%%%%%
%%% %1%%
%%    %%
%% %%%%%
%%^%%%%%
%%%%%%%%
