%%%%%%%%
%%%R%%%%
%%%  % %
%% %% %%
%%^% %%%
%%%%%%%%
