%%%%%%%%%
%%%%%%%%%
%%%%%%%%%
%%%R%R%%%
%%% % %%%
%%%%^%%%%
%%%%%%%%%