%%%%%%%%%
%%%%%%%%%
%%%%R% %%
%%%%% %%%
%%% % %%%
%%%%^%%%%
%%%%%%%%%
