%%%%%%%%%
%%%%%%%%%
%% %R% %%
%%% % %%%
%%% % %%%
%%%%^%%%%
%%%%%%%%%
